####################
# .                #
# .                #
# .                #
# .                #
# .                #
# .                #
# .                #
# .                #
# .     @ .        #
# .                #
# .                #
# . .              #
# . ###            #
# . #.#            #
# . #.#            #
# . . .            #
# . #              #
# .###......       #
####################